111111111
10ECP0001
100001001
111111111
