111111111
100000001
100001001
1111111111
