111111111
100000001
10000100z
111111111