111111111
100E000C1
1CCCP1CC1
1C00010E1
111111111