111111111
100000001
100001A01
111111111
