111111111
100000001
100001001
111111011
