111111111
100EP0001
100001001
111111111