111111111
100P00001
1000010C1
111111111
