1111111111111111111111111111111111111111111111111111
100E000C00010000000000000000000000000000000000000001
1CCCP1CC00000000000000000000010000000000000000000001
1C00010E00000000000000000000000000000000000000000001
1000010000000000000000000000000000000000000000000001
1000010000000000000000000000000000000000000000000001
1000010000000000000000000000000000000000000000000001
1000010000000000000000000000000000000000000000000001
1000010000000000000000000000000000000000000000000001
1000010000000000000000000000000000000000000000000001
1000010000000000000000000000000000000000000000000001
1000010000000000000000000000000000000000000000000001
1000010000000000000000000000000000000000000000000001
1000010000000000000000000000000000000000000000000001
1000010000000000000000000000000000000000000000000001
1000010000000000000000000000000000000000000000000001
1000010000000000000000000000000000000000000000000001
1000010000000000000000000000000000000000000000000001
1000010000000000000000000000000000000000000000000001
1000010000000000000000000000000000000000000000000001
1000010000000000000000000000000000000000000000000001
1000010000000000000000000000000000000000000000000001
1000010000000000000000000000000000000000000000000001
1000010000000000000000000000000000000000000000000001
1000010000000000000000000000000000000000000000000001
1000010000000000000000000000000000000000000000000001
1000010000000000000000000000000000000000000000000001
1000010000000000000000000000000000000000000000000001
1000010000000000000000000000000000000000000000000001
1000010000000000000000000000000000000000000000000001
1111111111111111111111111111111111111111111111111111