111111111
000000001
100001001
111111111