111111111
100E00001
100P01001
111111111
