111111111
100000001
100001000
111111111
