111111111
100E00001
1000010C1
111111111