11111111111111111111111111111111111111111111111111111111111111111111111111111
100E000C000100000000000000000000000000000000000000000000000000000000000000001
1CCCP1CC000000000000000000000100000000000000000000000000000000000000000000001
1C00010E000000000000000000000000000000000000000000000000000000000000000000001
10000100000000000000000000000000000000000000000000000000000000000000000000001
10000100000000000000000000000000000000000000000000000000000000000000000000001
10000100000000000000000000000000000000000000000000000000000000000000000000001
10000100000000000000000000000000000000000000000000000000000000000000000000001
10000100000000000000000000000000000000000000000000000000000000000000000000001
10000100000000000000000000000000000000000000000000000000000000000000000000001
10000100000000000000000000000000000000000000000000000000000000000000000000001
10000100000000000000000000000000000000000000000000000000000000000000000000001
10000100000000000000000000000000000000000000000000000000000000000000000000001
10000100000000000000000000000000000000000000000000000000000000000000000000001
10000100000000000000000000000000000000000000000000000000000000000000000000001
10000100000000000000000000000000000000000000000000000000000000000000000000001
10000100000000000000000000000000000000000000000000000000000000000000000000001
10000100000000000000000000000000000000000000000000000000000000000000000000001
10000100000000000000000000000000000000000000000000000000000000000000000000001
10000100000000000000000000000000000000000000000000000000000000000000000000001
10000100000000000000000000000000000000000000000000000000000000000000000000001
10000100000000000000000000000000000000000000000000000000000000000000000000001
10000100000000000000000000000000000000000000000000000000000000000000000000001
10000100000000000000000000000000000000000000000000000000000000000000000000001
10000100000000000000000000000000000000000000000000000000000000000000000000001
10000100000000000000000000000000000000000000000000000000000000000000000000001
10000100000000000000000000000000000000000000000000000000000000000000000000001
10000100000000000000000000000000000000000000000000000000000000000000000000001
10000100000000000000000000000000000000000000000000000000000000000000000000001
10000100000000000000000000000000000000000000000000000000000000000000000000001
10000100000000000000000000000000000000000000000000000000000000000000000000001
10000100000000000000000000000000000000000000000000000000000000000000000000001
10000100000000000000000000000000000000000000000000000000000000000000000000001
10000100000000000000000000000000000000000000000000000000000000000000000000001
10000100000000000000000000000000000000000000000000000000000000000000000000001
10000100000000000000000000000000000000000000000000000000000000000000000000001
10000100000000000000000000000000000000000000000000000000000000000000000000001
10000100000000000000000000000000000000000000000000000000000000000000000000001
10000100000000000000000000000000000000000000000000000000000000000000000000001
10000100000000000000000000000000000000000000000000000000000000000000000000001
11111111111111111111111111111111111111111111111111111111111111111111111111111